{6,-1}
......+.......
......+.......
............#.
.#..#.......#.
.#..#..#......
.#..#..#......
.#.....#......
.#.....#......
.#######......
..............
..............
....#.....#...
....#.....#...
....#.....#...
....#######...